15x15
i,i,i,i,i,i,i,i,i,i,i,i,i,i,i;
i,-,-,-,b,-,-,p,-,-,b,-,-,-,i;
i,-,e,-,b,-,-,-,-,-,b,-,e,-,i;
i,-,-,b,b,b,b,b,b,b,b,b,-,-,i;
i,b,b,b,-,-,-,b,-,-,-,b,b,b,i;
i,-,-,b,-,-,-,b,-,-,-,b,-,-,i;
i,-,-,b,-,-,-,b,-,-,-,b,-,-,i;
i,e,-,b,b,b,b,b,b,b,b,b,-,e,i;
i,-,-,b,-,-,-,b,-,-,-,b,-,-,i;
i,-,-,b,-,-,-,b,-,-,-,b,-,-,i;
i,b,b,b,-,-,-,b,-,-,-,b,b,b,i;
i,-,-,b,b,b,b,b,b,b,b,b,-,-,i;
i,-,e,-,b,-,-,-,-,-,b,-,e,-,i;
i,-,-,-,b,-,-,p2,-,-,b,-,-,-,i;
i,i,i,i,i,i,i,i,i,i,i,i,i,i,i