15x15
i,i,i,i,i,i,i,i,i,i,i,i,i,i,i;
i,-,-,-,b,-,-,e,-,-,b,-,-,-,i;
i,-,e,-,b,-,-,-,-,-,b,-,p,-,i;
i,-,-,b,b,b,b,b,b,b,b,b,-,-,i;
i,b,b,b,-,-,-,b,-,-,-,b,b,b,i;
i,-,-,b,-,-,-,b,-,-,-,b,-,-,i;
i,-,-,b,-,-,-,b,-,-,-,b,-,-,i;
i,e,-,b,b,b,b,b,b,b,b,b,-,e,i;
i,-,-,b,-,-,-,b,-,-,-,b,-,-,i;
i,-,-,b,-,-,-,b,-,-,-,b,-,-,i;
i,b,b,b,-,-,-,b,-,-,-,b,b,b,i;
i,-,-,b,b,b,b,b,b,b,b,b,-,-,i;
i,-,e,-,b,-,-,-,-,-,b,-,e,-,i;
i,-,-,-,b,-,-,e,-,-,b,-,-,-,i;
i,i,i,i,i,i,i,i,i,i,i,i,i,i,i