15x15
i,i,i,i,i,i,i,i,i,i,i,i,i,i,i;
i,-,-,-,-,-,-,e,-,-,-,-,-,-,i;
i,-,-,-,-,-,-,-,-,-,-,-,-,-,i;
i,-,-,b,b,b,b,b,b,b,b,b,-,-,i;
i,-,-,b,-,-,-,b,-,-,-,-,-,-,i;
i,-,-,b,-,-,-,b,-,e,e,-,-,-,i;
i,-,-,b,-,-,-,b,-,-,-,-,-,-,i;
i,e,-,b,b,b,b,p,b,b,b,b,-,e,i;
i,-,-,-,-,-,-,b,-,-,-,b,-,-,i;
i,-,-,b,b,b,b,b,b,b,b,b,-,-,i;
i,-,-,b,-,-,-,b,-,-,-,b,-,-,i;
i,-,-,b,b,b,b,b,b,b,b,b,-,-,i;
i,-,-,-,-,-,-,-,-,-,-,-,-,-,i;
i,-,-,-,-,-,-,e,-,-,-,-,-,-,i;
i,i,i,i,i,i,i,i,i,i,i,i,i,i,i