15x15
i,i,i,i,i,i,i,i,i,i,i,i,i,i,i;
i,-,b,-,-,-,-,b,-,b,-,-,-,-,i;
i,-,b,-,b,b,-,b,-,b,-,-,-,-,i;
i,-,b,-,e,-,-,b,-,b,-,-,-,-,i;
i,-,b,b,b,b,b,b,-,b,-,-,-,-,i;
i,-,-,-,-,-,-,b,e,b,-,-,-,-,i;
i,-,-,-,-,-,-,b,-,b,-,-,-,-,i;
i,-,-,-,p,-,-,b,-,b,-,-,-,-,i;
i,-,-,-,-,-,-,b,-,b,-,-,-,-,i;
i,-,-,-,-,-,-,b,-,b,-,-,-,-,i;
i,b,b,b,b,b,b,b,b,b,b,b,b,b,i;
i,b,b,b,b,b,b,b,b,b,b,b,b,b,i;
i,b,b,b,b,b,b,b,b,b,b,b,b,b,i;
i,b,b,b,b,b,b,b,b,b,b,b,b,b,i;
i,i,i,i,i,i,i,i,i,i,i,i,i,i,i