15x15
i,i,i,i,i,i,i,i,i,i,i,i,i,i,i;
i,-,-,-,-,-,-,e,-,-,-,-,-,-,i;
i,-,e,-,-,-,-,-,-,-,-,-,p,-,i;
i,-,-,b,-,-,-,b,b,b,b,b,-,-,i;
i,-,-,b,-,-,-,b,-,-,-,-,-,-,i;
i,-,-,b,-,-,-,b,-,-,-,-,-,-,i;
i,-,-,b,-,-,-,b,-,-,-,-,-,-,i;
i,e,-,b,b,b,b,b,b,b,b,b,-,e,i;
i,-,-,-,-,-,-,b,-,-,-,b,-,-,i;
i,-,-,-,-,-,-,b,-,-,-,b,-,-,i;
i,-,-,-,-,-,-,b,-,-,-,b,-,-,i;
i,-,-,b,b,b,b,b,-,-,-,b,-,-,i;
i,-,e,-,-,-,-,-,-,-,-,-,e,-,i;
i,-,-,-,-,-,-,p2,-,-,-,-,-,-,i;
i,i,i,i,i,i,i,i,i,i,i,i,i,i,i